n. noun 
v. verb 
adj. adjective 
pro. pronoun 
det. determiner 
conj. conjunction 
prep. preposition

ādafan-: n. success, victory
āšš-: n. (older) sister

bānyub-: n. bank, safe, vault 
bēt-: prep. without
biˤsuwi-: v. to rejoin, to join, to enter, to return to
bōt-: v. to carry, to hold

cīmkudu-: n. dance floor
cīmnē-: n. ascent, rising

datē-: v. to steal, to take
dayyasul-: n. possibility, potential, ability 
din: conj. that (subordinating) 
dōn-: n. hand, palm

fiš-: prep. at, in, while, around
fōšnē-: n. event, occurrence, happening 
furj-: v. to become, to turn into

huddatē-: n. hour, hourglass

ḫalf-: v. to escape

ḥun: pro. he, she, it, they (sing.), him, her (obl.), it (obl.), them (sing.)
ḥunyas: pro. his, her, hers, its, their (sing.), theirs (sing.)

jafud-: n. head
jēl-: n. crowd (of people), mob
jētsul-: n. purple (color), purpleness 
jēˤa-: n. emerald 

ka: pro. they (pl.), them (pl.)
karn-: n. foot, leg
kād-: det. all, every
kāsfan-: n. possession, item
kāt-: pro. everything, all
kēs: pro. their (pl.), theirs (pl.)

lib-: prep. like, as
lōˀ-: prep. with, for
lūḥa-: n. member of the nobility, lord, lady

mab-: v. to give, to provide
mablamaš-: v. to pass along, to hand over, to deliver 
mar-: v. to go
mart-: adj. easy, simple
mēbu-: adj. precious, expensive, valuable 
mēk-: n. moon (plurale tantum)
mēn-: adj. cold, frigid, icy; n. ice
micca-: v. to find, to discover 
miccaḫēr-: v. target, victim
mikkiwa-: n. evening sky, night sky
mikšēd-: n. night, nighttime 

nīlkiwa-: n. alley, alleyway, back road
nūnḫēr-: adj. half

rāmis-: v. to scatter, to distribute, to disperse 
rus-: prep. out from, before, until

sayyas: pro. my, mine
sē: pro. I, me
sōk-: n. speed, quickness, agility; adj. fast, quick, speedy
sōsul-: n. dark, darkness
surfan-: n. trace, remnant, remain
suri-: v. to remain (of time)

šēd-: n. moment, instant
šu-: prep. into, after, since, to
šuḫa-: det. this, these
šund-: n. way, manner, form, style, type

tē: conj. and

urīs-: n. cloud

warḥōb-: n. star
warwar-: v. to shine, to sparkle, to twinkle, to glimmer 
wādd-: adj. first, initial, primary
wē: conj. that (relative), which (relative), who (relative)
wuffusul-: n. necessity, need, requirement 

yē-: v. to be
yūdōfan-: n. party, festival

zōl-: v. to lose, to forget, to leak, to get rid of

əbōs-: v. to notice, to perceive 

ˤēlbəsul-: n. red (color), redness
ˤutsant-: adj. spinning, twirling, rotating 