1: The First Drengotian/Constant Empire
2: The German Empire
3: The Empire of the Hellenes/The (Second) Roman Empire
4: The Single/Kalavid Caliphate
--
a: Portocal
b: Leon and Navar
c: Aragon
d: Aquitaine
e: Barcelon
f: Valencia
-
g: Munster
h: Connaght
i: Sodrick
j: Wales
k: Scotland
l: Borland
m: Horther
n: Sweden
-
o: Genoa
p: Romaine
q: Tuscany
r: Rome
s: Venice
t: Crovatia
u: Servia
v: Hungary
w: Poland
x: Lithuania
y: Russia
z: Novgard
-
ɑ: Antioch
β: Tripoli
ɣ: Jerusalem 