υωðł¹²³

a¹ | and, also, as well as; before vowels = <ag>; triggers aspirate mutation
a² | adverbial particle, converts nouns into adverbs - hope > hopefully, e.g.; before vowels = <ac>; triggers aspirate mutation
am | around, about, either side of, on the subject of; on, beyond, near, towards; for (purpose), in order to; at (time), for (length of time); forms futures with <bod>; triggers soft mutation
amcan (m) | aim, objective, intention, purpose, plan, scheme
anadlυ | to breathe, respire
arhos | to stay, remain; to continue to be; to wait, to stop moving, to not go
arverol | usual, normal, familiar, customary
at | to, towards, up to; until
ato | third person masculine form of <at>; <ato heb ðal> "not to say that"
awel (f) | air, esp. outdoors; breeze, wind 
bod | to be; there be; auxiliary forming imperfective-aspect verb phrases with <yn²> and forming futures with <am>
boned (f) | bonnet, hat held in place with ribbons
bonheðiges (f) | noblewoman, lady
bore (m) | morning
byrreg | somewhat short, shortish
cał | aware, knowing, wise, in the know; <doωd yn gał> "to realise", lit. "to become aware"
canhwiłωr (m) | chandler, person who makes candles
catωm (f) | stamp, seal, certificate
catωmoeð | plural of <catωm>
cloren (f) | tail, queue, line of people, train of attendants
clorened | plural of <cloren>
dadangori | unmoor, leave port, set off (as a boat)
dal | hold, catch, capture; claim, be correct; <ato heb ðal> "not to say that"
dewiso | to choose, pick, opt for
dim | not, negative particle (in matrix clauses); no, none, not any; precedes the object or complement of the verb; thus usually appears as soft mutation <ðim>
diskyn | to descend, to go down; to alight, to get off, to dismount
divlastod | boredom, tedium; unpleasantness, annoyance, disgust
divyrrωh | amusement, recreation, time off; holiday, vacation
dow | third person singular nonpast of <doωd>
doωd | to come, to start (doing), to manage to; also <doωd a> "to bring, to accompany, to usher", <doωd yn> "to become"; <doωd yn gał> "to realise", lit. "to become aware"
drysυ | to confuse, baffle, perplex
ðim | see <dim>
dyn (m) | man
eb | say, said; quotative particle placed between the quote and the speaker
ehlysυr (m) | rarity, occasion
ei¹ | his, its (m); after final -i = 'w; after other vowels = 'i; triggers soft mutation
ei² | her, its (f); after final -i = 'w; after other vowels = 'i; triggers aspirate mutation
eih | your (pl); second person plural possessive; after vowels = 'h
ein | our; first person plural possessive; after vowels = 'n
galwad (f) | trip, visit, invitation, journey with desired endpoint
gał | third person singular nonpast of <gałυ>
gałυ | to be able, can; to manage, to succeed; 
gan | with, characterised by, made of; wearing (clothes), containing; triggers soft mutation
glad (f) | country, nation, homeland
glan (f) | side, edge; bank, shore	 
glanva (f) | dock, port, landing-place for boats or ships
govyn¹ | to ask, request, demand
govyn² | third person singular nonpast of <govyn¹>
greυd | to do, to make; auxiliary verb used to form perfective-aspect verb phrases
greωh | second person plural nonpast form of <greυd>
gυeła | to improve, get better, mend
gyda | with, beside, alongside; while, as, at the same time as (with possessed verbs); triggers aspirate mutation
'h | see <eih>
haeðυ | to deserve, merit; to endeavour, strive; to win, capture
heb | without, minus, lacking; <heb os> "without a doubt, certainly"; <ato heb ðal> "not to say that"
hi | she, her; third person feminine singular pronoun
hon | see <hωn>
hωn | (with definite noun) this; feminine <hon>
i | to, into; before, until (of time); triggers soft mutation
'i | see <ei¹>, <ei²>
iðo | third person masculine form of <i>
jeith (f) | language, speech
jωh | second person plural form of <i>
keυbal (m)| ferry, small boat
kyn | before, ahead of
kynhωsyðjon | plural of <kynhwisyð>; luggage, belongings
kynhwisyð (m) | container, holder; bag, suitcase
kyrhaeð | to arrive, to reach, to attain, to make it
łaveryð (m) | speaking, dialect, cant
łejaw | least, smallest, lowest, minimum; <o lejaw> "at least"
łong (f) | ship, boat, sea vessel
łoωnod (m) | signature, characteristic feature
łoωnoðjon | plural of <łoωnoðon>
łwir | complete, entire, utter, total
łymder (m) | sharpness, precision
mae | affirmative third person singular nonpast of <bod>
masnahωr (m) | businessman, merchant, trader
masnawhir | plural of <masnahωr>
mor (m) | sea, ocean
morled | marine, relating to the sea
mωgled | smoky, giving off smoke; cloudy (of material)
'n¹ | see <yn²>, <yn³>
'n² | see <ein>
na¹ | that ... not; particle preceding negative relative clauses; before vowels = <nad>; triggers mixed mutation
na² | do not, negative imperative marker; no, response to question; before vowels = <nad>; triggers mixed mutation
na³ | than; comparative particle before vowels - <nag>; triggers aspirate mutation
nad | see <na¹>, <na²>
nag | see <na³>
ne | preverbal question particle (not used with forms of <bod>); triggers soft mutation
ni¹ | not; preverbal negative particle; before vowels = <nid>; triggers mixed mutation
ni² | we, us | first person plural pronoun
nid | see <ni>
o¹ | from, out of, in, of; descended from, belonging to, pertaining to; since, because of, by (agent); triggers soft mutation
o² | he, him, it (m); third person masculine pronoun; after vowels = <vo>
oes | existential negative/interrogative third person singular nonpast of <bod>
ond | but, however
os | if
pentωrrυ | to collect, pick up; to store, hoard, pile up
pυn | what, which (one)
qυanga (m) | butler, manservant
'r | see <y>, <yr²>
rhoi | to give, offer, provide, pay
rhoωn | first person singular conditional of <rhoi>
rhυglinab | fluency, eloquence
rhυthredig | hurried, bustling, characterised by high activity and motion
sy | third person singular nonpast relative-clause form of <bod>
teithωr (m) | traveller, voyager, passenger, tourist
teithwir | plural form of <taithωr>
tavarn (f) | hotel, upscale temporary accommodation
tebyg | similar, alike, appearing
tomfei (m) | ticket, pass
trałodυs | vexed, distressed; harried, harrassed
tramor | overseas, foreign
trew (f) | town; neighbourhood, district; home
ty (m) | house, dwelling
tybjed | suppose, presume, judge; imagine, conjecture, guess
tybjωh | second person plural nonpast form of <tybjed>
υrðas (f) | dignity, nobility, honour
veg (m) | bus, autobus; free-moving public mass transport
vikin | local, regional, autochthonous
vo | see <o²>
ωrth | by, near, beside, at
whi | you (all); second person plural pronoun
y | the, definite article; following vowels = <'r>; before vowels = <yr>; triggers soft mutation in feminine singular nouns
ym | see <yn¹>
yn¹ | in, inside, at (a place); triggers nasal mutation; before p b m = <ym>; before c k g ng = <yng>
yn² | complement particle with <bod> "to be", preceding nominal, adjectival or verbal complements; after vowels = <'n>; triggers soft mutation with nouns and adjectives, but not with verbs
yn³ | adverbial particle, converts adjectives into adverbs; after vowels = <'n>; triggers soft mutation
yng | see <yn¹>
yr¹ | see <y>
yr² | preverbal particle, used in affirmative clauses, esp. in inverted syntaces in which an argument is moved in front of the verb; following vowels = <'r>