iiw	v	to celebrate
iwap	v	to be important
iya	n1	heart
ja	conj	as, but, so
jiish	v	to cause, to force
jixh	pron/n1	pronoun for N1
jǫǫs	v	to glow
jų	v	to be present
lan	v	to be blue
licash	n2	herb
luj	n1	moon
may	v	to look around, to search
nash	v	to be noticeable
nĕĕc	v	to help
nĭĭr	v	to be cold
nojs	v	to be loud
nyãc	n2	jewel, amulet
om	v	to be holy
omatyǫ̆	n1	priest
õw	v	to continue
ǫǫ	n1	female cousin
ǫweesh	v	to be brave
ǫ̆xuu	v	to hurry
pan	n1	spark
peexh	v	to be careful
pi	v	to be similar to
shãc	n2	megalith, obelisk
shăha	v	to manage
sham	n2	box, crate, chest
shi	v	to be silent
shų	n3	sky, heaven
shųųjãw	v	to be obligatory
sii	det	every, each
sĩy	v	to sing
sumiix	v	to follow
raws	n3>n4.coll	village
ra	v	to be sunny, to be clear
rij	v	to be with
rŏŏt	v	to jump
tamam	v	to wait
tici	n4	time
tiin	n4	easiness, ease
tųųnya	n3	ground
ushrŭ	v	to possess magical powers
uujcõ	v	to exit
uyem	v	to exceed
ų̃l	v	to be dark
ų̃lat	n4	darkness
ųųratiiw	n1	ceremony, celebration
wash	det/num	zero, none
wĭlujshų	n4	spring equinox
wiwi	n1	star
woosh	v	to be quick
wų̃ų̃r	v	to cover, to hide
xhup	v	to snatch
xhwă	v	to open
xacu	n3	shadow
xuuxh	v	to take
xwõõp	v	to leave
yalah	v	to lie on the ground
yiin	v	to approach
yĩy	v	to enter
yem	v	to protect
yǫ̆	n1	man, person
yųų	n2	hand
yųwa	n2	face, surface