a - pp. at, to (ag, all')
aïr - v. have (prs.3s a) (auxiliary)
acavar - v. manage, succeed (acavar a - succeed in, manage to)
affauðar - v. fade, weaken dilute
area - n. arena, plaza, plot (area fruy - dance floor)
aucoum - n. (bee)hive, swarm, crowd of people
autr - dm. other, different (toð autr - everything else)
baron - n. baron, minor nobleman
blau - ad. blue, dark blue (blau Dachin - indigo)
cainç - n. event, occasion, happening, occurrence
ciel - n. sky
cognit - disguise, secret, hiding place (ne cognit - inconspicuously, unnoticed, in disguise, in hiding)
communeyar - v. communicate, impart, pass along, pass on, hand off
Dackin ad. Deccan, Indian plateau (blau Dachin - indigo)
dar - v. give
de - pp. from, of, out of (dy, dell')
des - pp. out of, out from
dessur - ad. above, up above, on top
deïr - v. owe, have to, must (auxiliary)
demy - nm. half, one half (un demy hour - half an hour)
direct - ad. direct, straight, immediate
e - cj. and (cf. eð)
eç - dm. these, plural proximal
eð - cj. and (cf. e)
emposseïr - v. seize, take, steal
entað - n. item, thing, object
fagl - ad. easy, simple, straightforward
fair - v. make, do
fest - n. party, festival, banquet, soirée
freit - ad. cold
for - ad. only, just, except
fort - ad. well, very, really
fruy - n. dance
hour - n. time, hour
innuoðous - ad. cloudless
jo - pn. 1sg.nom, I 
jusc - pp. until
l' - dm. the, definite article (cf. y)
lou - pn. 3pl.acc, them
lugr - v. gleam, twinkle, glitter
luner - ad. lunar, of the Moon
man - n. hand
manton - n. cloak, blanket (manton noit - the dark of night)
me - pn. 1sg.obl, me, to me
meyon - pn. 1s.dem, by me
moment - n. moment, short time, instant, point in time
my - pn. 1sg.poss, my
ne - pp. in, into, inside (ny, nell')
noit - n. night, darkness
oc - dm. this, singular proximal
ort - n. rise, lift, ascent
osc - n. victim, target, mark
portar - v. carry, wear
pre - pp. before, (prell')
preu - nm. first, primary
pardr - v. lose (pst.ptcp pars)
preçous - ad. precious, valuable
rassistr - v. rejoin, attend again, come back to
remanir - v. remain, still be, be left (impersonal)
residu - n. remains, remnant, trace, residue
roug - ad. red
routel - n. alleyway, back street
scadrir - v. scatter
scap - n. escape, flight (scap fair de - escape from, get out of)
scapar - v. escape, flee, run away
smaraut - n. emerald
sortir - v. go out, leave, exit
sou - pp. under, underneath (soll')
sour - n. sister
star - v. be (prs.3s es) (auxiliary)
stel - n. star
sur - pp. on, above, on top of (sull')
tesoir - n. bank, stash, vault, safe
toð - dt. all, the whole
torneyar - v. spin, turn, revolve, rotate, waltz
trovar - v. find, discover, reach
un - nm. one, 1
un - dm. a, an, indefinite article
valir - v. be worth, should (impersonal)
vars - pp. towards, to
y - dm. the, definite article (cf. l')
yon - q. where, in what place; rel. where, when, (the place/the time) that