-a‘əx-xistyi: to trip, stumble
-a‘rən: be together, complete
-a‘wə: to look/search for
‘annə‘: time
-ansi: to sing
-antrə: to bound, lope
-aŋe: be loud
-aruxwə: to avoid, forgo
-astrə: to shine
‘axŋə: daytime
-axxwə: be quiet
-ayə: to span, cross
-exu: to sit
-exux: to place, set
-ə‘min: to join
-əmen: to remain, stay, wait
-ənnen: to see
-ənta: be big
-ənte: to cover
-ətra: to give, provide
‘ətru‘ə: night-time
‘əxayaxŋiyən: sunrise, morning
-i‘nye: to shudder, shake
-i‘nyu: to leave, exit
-i‘sə: be black, blue
¬-i‘tə: to like, want
-innyə: be cold
-inta: to stomp, dance
-intrə: to surround, hug
-irə: to do, perform
-itrət: to break, shatter
-ityə: to walk (perfective)
-me‘e: still, yet
məxən: 1SG reflexive
nə‘mu‘: cloud
ninsi‘: spark
-pan: distributive
-pi‘i: eagerly
Taŋa: house
Tassin: ceremony
Tinyen: role, purpose
tiŋwayən: altar, shrine
tiyupə: gem, precious stone
tuntətiyupəsə: amulet
tuwə: 3SG class V pronoun
-u‘tə: be wise, important
-u‘tyə: to pluck, pick out
-umət: to lack
-un: be similar to, resemble
-unə: to die
-unrə: to protect, defend
-untə: to hold, carry
-uŋŋə: to throw
-‘uŋwə: with ease, quickly
-utəpə: be obvious, trivial
-uyu: to lie down, sleep
Wa‘: who?
wastrəsə: star
watru: (male) cousin
waxŋə: sun
waya‘annə‘sə: time-traveller
wayən: world
wə‘pusə: healer, doctor
wəmux: woman
wətexə: sky, heaven
Wiŋwan: deity
witə: person
wuŋwityə: moon
xepə‘əpu‘sə: medicinal herbs
xəstrun: shadow, shade
xini: face
xiyəssi: sea, ocean