ajoli - to have ᴠ
alani - to perceive; to feel ᴠ
alanito - the state of being felt/perceived ᴀᴅᴊ
alo - golden; white; glowing ᴀᴅᴊ
aloja - 3SG ᴘʀᴏ
anavato - subjected to heat ᴀᴅᴊ
apa - future tense particle* ᴘᴛᴄʟ
ika - darkness ɴ
iko - dark ᴀᴅᴊ
ila - and ᴄᴏɴᴊ
ilaka - cause ɴ
ilaki - to cause; to create ᴠ
ilasi - to move ᴠ
ilasipoka - traceur ɴ
ilasita - something that has been moved ɴ
ilaso - relating to movement ᴀᴅᴊ
imala - the act of being inside/in the midst of smth ɴ
imali - to be inside; to be in the midst of ᴠ
imalita - place ɴ
isa - nounification particle** ᴘᴛᴄʟ
iso - adjectification particle** ᴘᴛᴄʟ
itota - intangible thing ɴ
kata - thing ɴ
kata talo - crystal; gem; jewel ɴ
kati - to exist ᴠ
lapa talo - sky ɴ
lavo - leader-like, of the leader ᴀᴅᴊ
ma - many; PL particle ᴀᴅᴊ; ᴘᴛᴄʟ
nivo - purple; cold grey ᴀᴅᴊ
oli - to/towards ᴘʀᴇᴘ
onipa - time ɴ
onipo - relating to time; timelike; having time ᴀᴅᴊ
oniti - to stay the same; to not move ᴠ
pa - negation particle ᴘᴛᴄʟ
sola - side; part ɴ
sili - to be one with smth ᴠ
silo - united, unified, etc. ᴀᴅᴊ
ta - four (4) ɴᴜᴍ
taja - 1SG ᴘʀᴏ
talo - light blue ᴀᴅᴊ
ti - one (1) ɴᴜᴍ
vo - big ᴀᴅᴊ

*goes after the subject(s) and all its descriptors, but before the object
**turns the previous sentence (structure starting with a verb or with two or more verbs connected with a conjunction) into one grammatically equivalent to a noun or an adjective with an appropriate meaning