Borland | island in the North Sea about twice the size of Wales
Vithor | university town on the west coast of Borland (Borlish Viðor)
Lustain | Portugal and Galicia
Mendeva | North America, from Basque mendebal, probably from Aquitain vent de val "valley wind"
Vask | Basque
Novamund | the New World
Aquitain | region of Vascony in southwest France, and the romance dialect spoken there
Vascony | polity whose core territory is in southwest France and northern Spain
Damvath | capital city of Borland for over a thousand years (Borlish Damvað)
Lepzi | capital city of Saxony at least in the 19th century
Saxony | polity in northern or eastern Germany occasionally controlling territory like Bohemia or Willemy
Willemy | Duchy analogous to Lotharingia
Barcelona | Spanish polity in the east of Spain
Burgundy | Gaulish polity in the south and east of France, and in Switzerland
Andalus | Southern region of Spain, sometimes independent but more often under Morrack control
Morrack | Morroco, with territory often including Andalucia and Algeria
Vetomund | the Old World, Eurasia
Bordew | Bordeaux, city on the west coast of France, major city in the Aquitain region of Vascony
Port Cale | city on the west coast of Spain in Portugal
Leon | Spanish territory, part of Vascony since its establishment
Braga | Portuguese town, the westernmost point of de facto Vascon control during the Vascon Ascendancy
Navarre | region of Vascony in northern Spain, south of Aquitain and east of Leon
Kernow | corresponds to Brittany, since the late 14th century controlled by Wales 
Britain | polity which in the modern day consists of Wales, parts of western England including Devon and Cornwall, and Brittany
Tremonow | town in Wales, founding place of the Brethin religious order - Monmouth/Trefynwy
Albion | Great Britain
Crovatia | Croatia
Barraut | town in Borland
Bohemia | polity in central Europe sometimes under Saxon control
Latin Republics | various polities on the Middlesea, early states to not be ruled by a monarch
Middlesea | Mediterranean

---
Belém/PA; Cuiabá/MT; Vitória/ES; Curitiba/PR; São Luís/MA e Aracaju/SE
Jacale, Novigarm, Waronøu, Awasouconda, Obaunasou eð Aracajou

---