*aiyer – prep. terminative case
*akeñäl – v.äl. to find
*ãŕof – n.in. trail/path
*bä – pron. nominative 3.AN
*bo – pron. disjunctive 3.AN
*bøläs – pron. instrumental-comitative 3.AN
*buabua – n.in. fun
*but – pron. reciprocal 3.AN
*ƀaix – n.an. movement
*ƀäñ – n.in. hate
*ƀo – pron. disjunctive 3.IN
*ƀö – pron. construct state 3.IN
*dä – det. partitive inanimate sg.
*đibwäl – v.äl. to search
*đuko – adj. every
*ezël – v.ël. to give
*fäþui – conj. but/however
*fëwä – n.in. studying
*fhoko – n.in. ability
*föcku – n.in. fear
*gøvloi – adj. bad
*gruyër – n.in. opportunity
*hirŕa – adj. weird
*höfmeu – n.an. spirit
*hõbou – n.an. shaman
*iaþ – n.in. knowledge (note that *iaþël (knowledge-INF(ËL.class)) is “to believe)**
*imrus – n.an tribe
*imrus – n.in home
*jëcä – n.in. voice
kaiŕõ – prep. causal case/because
*kwäl – v.äl. can
*mãije – n.an. dream
*mãije – n.an. vision
*nhesŕä – n.in. speech (note that *nhesŕäiv (speech-AGE(IL.class)) is “orator”)**
*of – prep. semblative case/like
*oizõ – n.in. village
*orcoi – n.an. friend**
*otsirs – n.in. destination
*otsirs – n.in. purpose
*öxü – conj. and (used in lists such that all things affected can occupy a single slot)
*öyav – n.an. eye
*õñãi – prep. antessive case/in front of/after (when used temporally)
*øþma – pron. distal demonstrative (also used to refer to things previously mentioned)
*ø̃f – pron. proximal demonstrative
*plixäl – v.äl. to want
*plixäl – v.äl. to miss (in the sense of longing for)
*pnev – adj. good
*pyaiso – n.an. group (of individuals)
*rëpnä – n.an. soul
*ro – pron. disjunctive 3.FEM (3pers. feminine)
*roif – n.an. hare (note : in the usage in the text, the “hare” is the Sun)
*ŕeon – n.in. sky
*serẽ – n.in. house
*serẽ – n.in shelter
*sŕäëv – n.in. truth
*ta – det. definite inanimate pl.
*tä – det. definite inanimate sg.
*të – det. definite animate sg.
*ü – conj. and (standard form)
*übõ – n.in. thought
*wä – pron. nominative 1pers.
*wo – pron. disjunctive 1pers.
*wõ – n.an. ancestor
*ye – pron. dative 1pers.
yö – pron. construct state 1pers.
*yølg – n.in. present (as in the time frame)
yut – pron. reciprocal 1pers.
*yüol – adj. happy
*zuho – adj. tired
*þüƀä – prep. lative case