Lexicon
Verb stems are listed in the following order: infinitive, perfective, imperfective.
a – at, towards
ad, dio-, diǒ- – shine, be bright
afs – trail
dágíítkarn – barbarian
dark, darkaí-, darkoǐ- – to turn, to happen
daś – though, until (marks volitive when used with a future verb. Comes at the end of the phrase)
diǐk – gold
diótǎr – time, era
dŋiîź – darkness
dófŋ – king, royal (n./adj.)
dógv, dgaf-, dógví- – to stand
faóŋdaǐk – treasure, hoard
fśakr – family, kind, shape, -like
ga – from
gíff, gvíf-, gíff- – see
gofn – big
goíś - four
-íd – singular locative
ik, ga-, gní- – leave, exit
kagg – sky
ktadźar – stage
no – and                               
ŋafán – everything (plural)
oâtś, tśa-, tśaí- – to come
piśiz (pl. piśasn) - corner
pfídq – part, fragment, piece
qtó, qfa-, qtó- – to take
rarŋ – canyon
rasót, rasóta-, rasót – be purple
rnoǒ - moon
rśat – older sister
rśat gofn – oldest sister
sâdź, sâdźa-, sâdź – be cloudy
śêtś – small
śfíkf – then, at that time
smaf (LOC: smadv) – night
tídźiǐk - sapphire
tqǎś, tqǎśa-, tqǎś- – be red
tkatr, tkatra-, tkatr- – walk, follow along
