akrat – v. to hold together, to maintain structural integrity
alar – ad. only, merely, just, barely
áłaʕ – pt. DISCONTINUOUS PERFECTIVE
ar – pt. PLURAL
áʕe – v. to be
eklór – ad. many, several, plural, divers
étí – prn. 3PL
giîs – v. track, trace, follow, tail, shadow
giré – det. ALL OF THOSE THERE, ALL OF YON
ĝi – n. thing, object, stuff, item
ĝus – prn. 1SG
haðál – nmlz. PERSON WHO DOES S.TH.
hae – prn. RELATIVE; CLAUSAL SUBORDINATOR
hákða – v. to feel
hoh – v. to move
höhsë – num. four
hún – n. dark color, cool color, dark, cool
iál – det. many
ikłe – n. time, instance, occasion
ilág – v. to glow, to give off light
íotéĝ – n. crossroads, junction, meeting point, fork
it – pt. REFLEXIVE PARTICIPLE
itü – pt. CONTINUOUS PERFECTIVE
káhak – ad. half, half-an-X
káhn – n. night
kéł – v. to be in, to be within, to be inside
lágr – n. crystal, crystalline rock
lulu – n. worm
lü – prn. INDEFINITE
łá – cn. and
m – ad. very, really, much, intensely
maĝ – ip. lacking, without, in lack of, minus, sans
n – pt. GENITIVE
néem – v. to carry out midlevel administrative tasks
nôgét – v. warm, heat, get the temperature of X up
nüh – ip. like, similar to, similarly to, akin to, much like
o – pt. CARDINAL TO ORDINAL
öð – cs. and
ör – cs. but
r – pt. NEGATIVE
re – v. to exist, to manifest, to be, to have a form
sar – v. to see, to observe
ség – for the cause of, for the sake of
síkna – n. warm color, light color, warm, light
taáð – n. sky, air, airmass, atmosphere
tágr – v. go from, go away, go away from, leave, take one's leave
té – pt. ACTIVE PARTICIPLE
tékða – n. day
téké – v. to go towards, to be in motion towards a destination
téreg – ad. uncomfortably close in, packed in, lacking room to move, lacking comfortable space
uátak – v. to have, to possess, to have with one
uðák – ad. dim, thin, slight, high-pitched
úh – pt. PASSIVE PARTICIPLE
ü – det. DEFINITE